//MAP CONVERTED BY dmm2tgm.py THIS HEADER COMMENT PREVENTS RECONVERSION, DO NOT REMOVE
"a" = (
/turf/closed/indestructible/riveted/uranium,
/area/lavaland/surface/outdoors)
"c" = (
/turf/open/water/cursed_spring,
/area/lavaland/surface/outdoors)
"d" = (
/obj/item/paper/crumpled{
	info = "When one falls into this hot spring, they shall forever be turned into..."
	},
/turf/open/floor/plating/beach/sand,
/area/lavaland/surface/outdoors)
"l" = (
/obj/item/tcg_card/special/morph,
/turf/open/floor/plating/beach/sand,
/area/lavaland/surface/outdoors)
"I" = (
/turf/open/floor/plating/asteroid/basalt/lava_land_surface,
/area/lavaland/surface/outdoors)
"L" = (
/obj/structure/fluff/beach_umbrella,
/turf/open/floor/plating/beach/sand,
/area/lavaland/surface/outdoors)
"U" = (
/turf/open/floor/plating/beach/sand,
/area/lavaland/surface/outdoors)

(1,1,1) = {"
I
I
I
I
I
I
I
I
I
I
I
"}
(2,1,1) = {"
I
I
I
a
a
I
a
a
I
I
I
"}
(3,1,1) = {"
I
I
a
U
U
U
U
U
a
I
I
"}
(4,1,1) = {"
I
a
U
L
c
c
c
l
U
a
I
"}
(5,1,1) = {"
I
a
U
c
c
c
c
c
U
a
I
"}
(6,1,1) = {"
I
I
U
c
c
c
c
c
U
I
I
"}
(7,1,1) = {"
I
a
U
c
c
c
c
c
U
a
I
"}
(8,1,1) = {"
I
a
U
L
c
c
c
U
U
a
I
"}
(9,1,1) = {"
I
I
a
U
U
d
U
U
a
I
I
"}
(10,1,1) = {"
I
I
I
a
a
I
a
a
I
I
I
"}
(11,1,1) = {"
I
I
I
I
I
I
I
I
I
I
I
"}
