//MAP CONVERTED BY dmm2tgm.py THIS HEADER COMMENT PREVENTS RECONVERSION, DO NOT REMOVE
"b" = (
/turf/open/floor/plating/asteroid/basalt/lava_land_surface,
/area/lavaland/surface)
"h" = (
/mob/living/simple_animal/hostile/bear/snow,
/turf/closed/mineral/random/snow,
/area/mine/abandoned)
"j" = (
/mob/living/simple_animal/hostile/asteroid/hivelord/legion/snow,
/turf/closed/mineral/random/snow,
/area/mine/abandoned)
"R" = (
/turf/closed/mineral/random/snow,
/area/mine/abandoned)
"T" = (
/turf/closed/indestructible/rock/snow/ice/ore,
/area/lavaland/surface/outdoors/unexplored)

(1,1,1) = {"
b
b
b
b
b
b
b
b
b
b
b
b
b
b
b
b
b
b
b
b
b
b
b
b
b
b
b
b
b
b
b
b
b
b
b
b
b
b
b
b
"}
(2,1,1) = {"
b
b
b
b
b
b
b
b
b
b
b
b
b
b
b
b
b
b
b
b
b
b
b
b
b
b
b
b
b
b
b
b
b
b
b
b
b
b
b
b
"}
(3,1,1) = {"
b
b
b
T
T
T
T
T
T
T
T
T
T
T
T
T
T
T
T
T
T
T
T
T
T
T
T
T
T
T
T
T
T
T
T
T
T
b
b
b
"}
(4,1,1) = {"
b
b
T
T
T
T
T
T
T
T
T
T
T
T
T
T
T
T
T
T
T
T
T
T
T
T
T
T
T
T
T
T
T
T
T
T
T
T
b
b
"}
(5,1,1) = {"
b
b
T
T
T
T
T
T
T
T
T
T
T
T
T
T
T
T
T
T
T
T
T
T
T
T
T
T
T
T
T
T
T
T
T
T
T
T
b
b
"}
(6,1,1) = {"
b
b
T
T
T
T
T
T
T
T
T
T
T
T
T
T
T
T
T
T
T
T
T
T
T
T
T
T
T
T
T
T
T
T
T
T
T
T
b
b
"}
(7,1,1) = {"
b
b
T
T
T
T
T
T
T
T
T
T
T
T
T
T
T
T
T
T
T
T
T
T
T
T
T
T
T
T
T
T
T
T
T
T
T
T
b
b
"}
(8,1,1) = {"
b
b
T
T
T
T
T
T
T
T
T
T
T
T
T
T
T
T
T
T
T
T
T
T
T
T
T
T
T
T
T
T
T
T
T
T
T
T
b
b
"}
(9,1,1) = {"
b
b
T
T
T
T
T
T
T
T
T
T
T
T
T
T
T
T
T
T
T
T
T
T
T
T
T
T
T
T
T
T
T
T
T
T
T
T
b
b
"}
(10,1,1) = {"
b
b
T
T
T
T
T
T
T
T
T
T
T
T
T
T
T
T
T
T
T
T
T
T
T
T
T
T
T
T
T
T
T
T
T
T
T
T
b
b
"}
(11,1,1) = {"
b
b
T
T
T
T
T
T
T
T
T
T
T
T
T
T
T
T
T
T
T
T
T
T
T
T
T
T
T
T
T
T
T
T
T
T
T
T
b
b
"}
(12,1,1) = {"
b
b
T
T
T
T
T
T
T
T
T
T
T
T
T
T
T
T
T
T
T
T
T
T
T
T
T
T
T
T
T
T
T
T
T
T
T
T
b
b
"}
(13,1,1) = {"
b
b
T
T
T
T
T
T
T
T
T
T
T
T
T
T
T
T
T
T
T
T
T
T
T
T
T
T
T
T
T
T
T
T
T
T
T
T
b
b
"}
(14,1,1) = {"
b
b
T
T
T
T
T
T
T
T
T
T
T
T
T
T
T
T
T
T
T
T
T
T
T
T
T
T
T
T
T
T
T
T
T
T
T
T
b
b
"}
(15,1,1) = {"
b
b
T
T
T
T
T
T
T
T
T
T
T
T
T
T
T
T
T
T
T
T
T
T
T
T
T
T
T
T
T
T
T
T
T
T
T
T
b
b
"}
(16,1,1) = {"
b
b
T
T
T
T
T
T
T
T
T
T
T
T
T
T
T
T
T
T
T
T
T
T
T
T
T
T
T
T
T
T
T
T
T
T
T
T
b
b
"}
(17,1,1) = {"
b
b
T
T
T
T
T
T
T
T
T
T
T
T
T
T
T
T
T
T
T
T
T
T
T
T
T
T
T
T
T
T
T
T
T
T
T
T
b
b
"}
(18,1,1) = {"
b
b
T
T
T
T
T
T
T
T
T
T
T
T
T
T
T
T
T
T
T
T
T
T
T
T
T
T
T
T
T
T
T
T
T
T
T
T
b
b
"}
(19,1,1) = {"
b
b
T
T
T
T
T
T
T
T
T
T
T
T
T
T
T
T
R
R
R
R
T
T
T
T
T
T
T
T
T
T
T
T
T
T
T
T
b
b
"}
(20,1,1) = {"
b
b
T
T
T
T
T
T
T
T
T
T
T
T
T
T
T
T
R
j
R
R
T
T
T
T
T
T
T
T
T
T
T
T
T
T
T
T
b
b
"}
(21,1,1) = {"
b
b
T
T
T
T
T
T
T
T
T
T
T
T
T
T
T
T
R
R
R
R
T
T
T
T
T
T
T
T
T
T
T
T
T
T
T
T
b
b
"}
(22,1,1) = {"
b
b
T
T
T
T
T
T
T
T
T
T
T
T
T
T
T
T
R
R
R
h
T
T
T
T
T
T
T
T
T
T
T
T
T
T
T
T
b
b
"}
(23,1,1) = {"
b
b
T
T
T
T
T
T
T
T
T
T
T
T
T
T
T
T
T
T
T
T
T
T
T
T
T
T
T
T
T
T
T
T
T
T
T
T
b
b
"}
(24,1,1) = {"
b
b
T
T
T
T
T
T
T
T
T
T
T
T
T
T
T
T
T
T
T
T
T
T
T
T
T
T
T
T
T
T
T
T
T
T
T
T
b
b
"}
(25,1,1) = {"
b
b
T
T
T
T
T
T
T
T
T
T
T
T
T
T
T
T
T
T
T
T
T
T
T
T
T
T
T
T
T
T
T
T
T
T
T
T
b
b
"}
(26,1,1) = {"
b
b
T
T
T
T
T
T
T
T
T
T
T
T
T
T
T
T
T
T
T
T
T
T
T
T
T
T
T
T
T
T
T
T
T
T
T
T
b
b
"}
(27,1,1) = {"
b
b
T
T
T
T
T
T
T
T
T
T
T
T
T
T
T
T
T
T
T
T
T
T
T
T
T
T
T
T
T
T
T
T
T
T
T
T
b
b
"}
(28,1,1) = {"
b
b
T
T
T
T
T
T
T
T
T
T
T
T
T
T
T
T
T
T
T
T
T
T
T
T
T
T
T
T
T
T
T
T
T
T
T
T
b
b
"}
(29,1,1) = {"
b
b
T
T
T
T
T
T
T
T
T
T
T
T
T
T
T
T
T
T
T
T
T
T
T
T
T
T
T
T
T
T
T
T
T
T
T
T
b
b
"}
(30,1,1) = {"
b
b
T
T
T
T
T
T
T
T
T
T
T
T
T
T
T
T
T
T
T
T
T
T
T
T
T
T
T
T
T
T
T
T
T
T
T
T
b
b
"}
(31,1,1) = {"
b
b
T
T
T
T
T
T
T
T
T
T
T
T
T
T
T
T
T
T
T
T
T
T
T
T
T
T
T
T
T
T
T
T
T
T
T
T
b
b
"}
(32,1,1) = {"
b
b
T
T
T
T
T
T
T
T
T
T
T
T
T
T
T
T
T
T
T
T
T
T
T
T
T
T
T
T
T
T
T
T
T
T
T
T
b
b
"}
(33,1,1) = {"
b
b
T
T
T
T
T
T
T
T
T
T
T
T
T
T
T
T
T
T
T
T
T
T
T
T
T
T
T
T
T
T
T
T
T
T
T
T
b
b
"}
(34,1,1) = {"
b
b
T
T
T
T
T
T
T
T
T
T
T
T
T
T
T
T
T
T
T
T
T
T
T
T
T
T
T
T
T
T
T
T
T
T
T
T
b
b
"}
(35,1,1) = {"
b
b
T
T
T
T
T
T
T
T
T
T
T
T
T
T
T
T
T
T
T
T
T
T
T
T
T
T
T
T
T
T
T
T
T
T
T
T
b
b
"}
(36,1,1) = {"
b
b
T
T
T
T
T
T
T
T
T
T
T
T
T
T
T
T
T
T
T
T
T
T
T
T
T
T
T
T
T
T
T
T
T
T
T
T
b
b
"}
(37,1,1) = {"
b
b
T
T
T
T
T
T
T
T
T
T
T
T
T
T
T
T
T
T
T
T
T
T
T
T
T
T
T
T
T
T
T
T
T
T
T
T
b
b
"}
(38,1,1) = {"
b
b
b
T
T
T
T
T
T
T
T
T
T
T
T
T
T
T
T
T
T
T
T
T
T
T
T
T
T
T
T
T
T
T
T
T
T
b
b
b
"}
(39,1,1) = {"
b
b
b
b
b
b
b
b
b
b
b
b
b
b
b
b
b
b
b
b
b
b
b
b
b
b
b
b
b
b
b
b
b
b
b
b
b
b
b
b
"}
(40,1,1) = {"
b
b
b
b
b
b
b
b
b
b
b
b
b
b
b
b
b
b
b
b
b
b
b
b
b
b
b
b
b
b
b
b
b
b
b
b
b
b
b
b
"}
