"a" = (/turf/template_noop,/area/template_noop)
"b" = (/turf/closed/mineral/volcanic/lava_land_surface,/area/lavaland/surface/outdoors)
"c" = (/turf/open/floor/plating/asteroid/basalt/lava_land_surface,/area/lavaland/surface/outdoors)
"d" = (/obj/item/dnainjector/psiheal,/turf/open/floor/plating/asteroid/basalt/lava_land_surface,/area/lavaland/surface/outdoors)

(1,1,1) = {"
ababa
bcbcb
bcdcb
bcccb
abbba
"}
